SO textures/metS.xpm
WE textures/metW.xpm
NO textures/metN.xpm
EA textures/metE.xpm

C 250,240,190
F 250,240,230

111111111111
1000000000011111111111111111111111111
1000000000011111111111111111
10000000000D00000000000001
10000000000111111111111111
100011100001
10001N100001
100010100001
11D11D111111
100000000001
100000000001
100000000001 
100000000001
100000000001
100000000001
100000000001
100000000001
100000000001
100000000001
100000000001
111111111111