SO textures/minusS.xpm
WE textures/squareW.xpm
NO textures/plusN.xpm
EA textures/rombusE.xpm

C 178, 102, 255
F 108, 0, 255

111111111111111111111111111111111111
100000000000000000000000000000000001
1111111111111111111111111111111100011111
1000000000000100000000000000000000000001
1111111111111111111111111111111111111001
1111111111111111111111111111111111111001
1000000000000100000000000000000000000001
1111111111111110000011111111111111111111
111111111111111000001
11111111111111111S111111
111111111111111111111111